Music used in adventure

Prologue: Cinematrix - Revolve (R Mix) By: Hacknet
Chapter1: Magical Flora By: Tabletop Audio
Bad Ending Music: Hello Zepp + Overture (Saw Theme)
Bad Ending Dialogue: Game Over by John Kramer
Adventure Begins: KINGSMAN: THE SECRET SERVICE - MAIN THEME
Chapter 2 Forest night: Long Rest by Tabletop Audio
Wolf Battle Music: Dragonfire: The Ultimate D&D Battle by Soundscape Freeflow
Death Music: Death Music by Subnautica
Chapter 3 start music: I Dream Of Flying by Johan Fredrik
InnMusic: Medieval Fantasy Tavern | D&D Fantasy Music and Ambience By Daydreaming of Persephone
TownMusic: Goodhaven By Tabletop Audio
Meeting Maji Music: The Misty Marsh By Tabletop Audio
The two GoatRiders: Necropolis By Tabletop Audio
Training Starts: The Adventure Begins By Howard Shore
Morning Theme: Middle Earth:Dawn By Tabletop Audio
Market Theme: All Roads Lead to Hogsmeade By Peter Murray
Market Battle: A Market Day's Merriment By SoundScape FreeFlow
Solving the name theme: Operator (Main Menu) By Spinozarre
Harbour Ambience: Harbour Ambience and Music By Martia's Muses
Pirates Singing: Sails Of Glory By SoundScape FreeFlow
Ocean at night: Open Ocean By Tabletop Audio
Abyssal Isle: Quiet Cove By Tabletop Audio
Terminus Minion battle music: Waterblight Ganon Battle By Nintendo
Manji's Death Music: Naomi Misora's Death By Death Note
Run Music: Escape! By Spinozarre
Nearing Terminus: Hidden Passage By Tabletop Audio
Terminus Theme: Lava King's Lair By Tabletop Audio
Terminus Battle Music: So i tried making a Boss Theme... By Chocominh
Alysandra Apears: The Flight By Ubisoft Music
Alysandra Theme: Ezio's Family By Jesper Kyd
Peacefull Ending Theme: The Legend of Zelda: Breath of the Wild - Theme By Nintendo
Stay and Change Ending Theme: Sirius By Cobra Kai
Credit music: The Walking Dead Season 4 intro By TellTale